husokachnout	husokachnu
omýt	omyjeme
osušit	osušíme
nadrtit	nadrtíme
osolit	osolíme
okmínovat	okmínujeme
posypat	posypeme
nakrájet	nakrájíme
přepůlit	přepůlíme
dát	dáme
dát	dáme
přihodit	přihodíme
položit	položíme
podlít	podlijeme
přiklopit	přiklopíme
dát	dáme
péct	pečeme
stáhnout	stáhneme
péct	pečeme
péct	pečeme
